10 10 0
#        #
#        #  
##D###  ^#     
#  * #   #  
#    #   #
######   #    
# F  %  ^# 
#L       # 
# $* * I #
##########     