15 20 4
####################
#   #  ****  #     #
#   #     *  #   * #
# * D  *  *  #     #
#   #    #*  ####D##
#   #  % #         #
##### I  #  ^  F   #
# F   $  # $     ^ #
#  T *   #         #
###  * #########  ##
#    *     $#      #
##D## *     #      #
#   # *$ ^  #   F  #
# * # *     # ^    #
#################### 

